指数	指
银行	银
石油	油
保险	险
酿酒	酒
煤炭	煤
电力	电力
房产	产
汽车	车
交运	运
工建	建
券商	券
家电	家
农渔	渔
安防	防
信息	咨
船舶	船
港口	港
配电	输电
电信	电信
医药	药
食品	食
机械	械
百货	商
物流	物
民航	飞
钢铁	钢
水泥	泥
传媒	传
原件	元件
软件	软
贵金	贵
航空	航
化工	化
有色	色
通讯	讯
材料	材
多元	融
环保	环
纺织	纺
高速	速
玻璃	璃
旅游	旅
金属	金
园林	园
化纤	纤
农药	兽
公用	公
化肥	肥
医疗	疗
仪表	表
塑胶	塑
装修	饰
国贸	贸
木业	木
珠宝	珠
综合	综
期货	期